14
1,7,6,3,6,1,7,5,7,5,6,3,5,4
1,12,9,12,11,5,14,1,15,4,11,15,7,6
2,3,5,5,15,5,12,3,15,4,8,8,8,10
10,9,7,4,11,4,3,12,9,7,5,7,4,10
10,3,13,5,15,4,10,2,3,13,5,13,7,12
11,13,7,4,9,7,13,13,13,6,1,6,9,6
8,1,13,6,3,14,3,6,1,15,5,13,5,14
1,7,5,12,10,8,9,13,5,15,5,5,7,12
3,14,3,4,11,5,5,5,7,13,7,5,13,4
10,10,9,6,11,6,3,5,13,5,15,4,3,6
11,14,1,14,10,9,15,5,4,1,13,6,8,10
10,11,7,12,10,2,11,7,5,5,5,12,3,12
10,10,9,7,15,14,11,13,7,7,5,5,13,4
8,8,1,13,12,8,9,4,9,13,5,5,5,4